NO ./textures/default/azul.xpm
SO ./textures/default/amarelo.xpm
WE ./textures/default/verde.xpm
EA ./textures/default/rosa.xpm

F 251,186,117
C 229,229,229

111111111
100000001
10111S111
101 101 1
101110111
100000001
101111111
101     1
101111111
100000001
111111111