NO ./texturas/default/azul.xpm
SO ./texturas/default/amarelo.xpm
WE ./texturas/default/verde.xpm
EA ./texturas/default/rosa.xpm

F 251,186,117
C 229,229,229

11111
1X0N1
10001
11111