NO ./textures/default/azul.xpm
SO ./textures/default/amarelo.xpm
WE ./textures/default/verde.xpm
EA ./textures/default/rosa.xpm

F 251,186,117
C 229,229,229

1111111
1001N1
1000011
1111