NO ./textures/default/azul.xpm
SO ./textures/default/amarelo.xpm
WE ./textures/default/verde.xpm
EA ./textures/default/rosa.xpm

F 251,186,117
# C (ceil) faltando aqui!

11111
1N001
11111