NO ./textures/default/azul.xpm
SO ./textures/default/amarelo.xpm
WE ./textures/default/verde.xpm
EA ./textures/default/rosa.xpm

F 251,186,117
C 229,229,229

1111
100001
10N001
100001
111111