NO ./textures/biblioteca/estante1.xpm
SO ./textures/biblioteca/estante1.xpm
WE ./textures/biblioteca/estante2.xpm
EA ./textures/biblioteca/estante2.xpm

F 85,53,33
C 30,19,12

1111111111111
1000001000001
1011101011101
1010001010001
1010111010111
1010000010001
1011111011101
1000001000001
1110111010111
1000100010001
1011101110101
10000000000N1
1111111111111