NO ./textures/praia/predios.xpm
SO ./textures/praia/predios2.xpm
WE ./textures/praia/praia.xpm
EA ./textures/praia/frente.xpm

F 41,33,38
C 86,130,148

1111
100011111
1000000001
100111111
10000000W1
100111111
1000000001
100111111
1000000001
100111111
1000000001
100111111
1000000001
100111111
1000000001
100111111
1000000001
111111111
